##################################################
#................................................#
#................................................#
#................................................#
#.............###################................#
#.............#.................#................#
#.............########.....######................#
#................................................#
#................................................#
#................................................#
##################################################
