##################################################
#..........#.....................................#
#..........#.....................................#
#..........#...........##################.......#
#..........#...................#.................#
#..............................#.................#
#..............................#.................#
###########....................#................#
#..............................#.................#
#......................##################........#
#................................................#
#................................................#
#................................................#
#................................................#
#................................................#
#................................................#
#................................................#
#................................................#
#................................................#
#................................................#
#................................................#
#................................................#
#................................................#
#................................................#
#................................................#
#................................................#
#................................................#
#................................................#
#................................................#
##################################################
